10011001100100111100
11100010011001000010
01000100000010000100
01000000000000000010
01222000000000000010
01000000000000000010
01000000000000000010
01000000000000022210
11000000111000001110
00111111000111110000